[Level] 1
[TerrainLayout]
10 45

0	0	20	10	0	0	20	10 	0	10
1	2	2	2	3	10	1	2	2	3
4	5	5	5	13	2	14	5	5	6
4	5	5	5	5	5	5	5	5	6
4	5	5	5	5	5	5	5	5	6
16	5	5	5  	5	5	5	5	5	17
4	5	5	5	5	5	5	5	5	6
4	5	5	5	5	5	5	5	5	6
4	5	5	5	5	5	5	5	5	6
16	5	5	5  	5	5	5	5	5	17
4	5	5	5	5	5	5	5	5	6
4	5	5	5	5	5	5	5	5	6
4	5	5	5	5	5	5	5	5	6
16	5	5	5	5	5	5	5	5	6
4	5	5	5	5	5	5	5	5	6
7	12	5	5	5	5	5	5	11	9
0	4	5	5  	5	5	5	5	6	0
1	14	5	5	5	5	5	5	13	3
4	5	5	5	5	5	5	5	5	6
4	5	5	5	5	5	5	5	5	6
16	5	5	5  	5	5	5	5	5	17
4	5	5	5	5	5	5	5	5	6
4	5	5	5	5	5	5	5	5	6
4	5	5	5	5	5	5	5	5	6
16	5	5	5  	5	5	5	5	5	17
4	5	5	5	5	5	5	5	5	6
4	5	5	5	5	5	5	5	5	6
16	5	5	5  	5	5	5	5	5	17
4	5	5	5	5	5	5	5	5	6
4	5	5	5	5	5	5	5	5	6
4	5	5	5	5	5	5	5	5	6
7	8	8	12 	5	5	11	19	8	9
1	18	2	14	5	5	13	2	2	3
4	5	5	5	5	5	5	5	5	6
4	5	5	5	5	5	5	5	5	6
4	5	5	5	5	5	5	5	5	6
4	5	5	5	5	15	5	5	5	6
4	5	5	5	5	5	5	5	5	6
4	5	5	5	5	5	5	5	5	6
16	5	5	5  	5	5	5	5	5	17
4	5	5	5	5	5	5	5	5	6
4	5	5	5	5	5	5	5	5	6
4	5	5	5	5	5	5	5	5	6
4	5	5	5	5	5	5	5	5	6
4	5	5	5	5	5	5	5	5	6

[Player]
300 2500 0 0 -0.5

[Enemies]
17
1 200 250 0 0 0.5
1 300 250 0 0 0.5
1 400 250 0 0 0.5
0 200 500 0 0 0.5
0 300 500 0 0 0.5
0 400 500 0 0 0.5
1 300 750 0 0 0.5
3 40 1000 0 0 0.5
3 560 1000 0 0 0.5
0 200 1250 0 0 0.5
0 300 1250 0 0 0.5
0 400 1250 0 0 0.5
0 300 1500 0 0 0.5
0 300 1850 0 0 0.5
4 180 1925 0 0 0.5
4 420 1925 0 0 0.5
4 330 2200 0 0 0.5

[SpecialObjects]
5
0 250 250
3 300 500
1 300 1000
3 300 1500
1 300 2000

[Level] 2
[TerrainLayout]
10 45

0	0	20	10	0	0	20	10 	0	10
1	2	2	2	2	2	2	2	2	3
4	5	5	5	5	5	5	5	5	6
4	5	5	5	5	5	5	5	5	6
4	5	5	5	5	5	5	5	5	6
16	5	5	5  	5	5	5	5	5	17
4	5	5	5	5	5	5	5	5	6
4	5	5	5	5	5	5	5	5	6
4	5	5	5	5	5	5	5	5	6
16	5	5	5  	5	5	5	5	5	17
4	5	5	5	5	5	5	5	5	6
4	5	5	5	5	5	5	5	5	6
4	5	5	5	5	5	5	5	5	6
4	5	5	5	5	5	5	5	5	6
4	5	5	5	5	5	5	5	5	6
4	5	5	5	5	5	5	5	5	6
16	5	5	5  	5	5	5	5	5	17
4	5	5	5	5	5	5	5	5	6
4	5	5	5	5	5	5	5	5	6
4	5	5	5	5	5	5	5	5	6
16	5	5	5  	5	5	5	5	5	17
4	5	5	5	5	5	5	5	5	6
4	5	5	5	5	5	5	5	5	6
4	5	5	5	5	5	5	5	5	6
16	5	5	5  	5	5	5	5	5	17
4	5	5	5	5	5	5	5	5	6
7	8	8	8	8	12 	5	11	8	9
1	18	2	2	2	14	5	13	2	3
4	5	5	5	5	5	5	5	5	6
16	5	5	5  	5	5	5	5	5	17
4	5	5	5	5	5	5	5	5	6
4	5	5	5	5	5	5	5	5	6
4	5	5	5	5	5	5	5	5	6
7	8	8	12 	5	5	11	19	8	9
1	18	2	14	5	5	13	2	2	3
4	5	5	5	5	5	5	5	5	6
4	5	5	5	5	5	5	5	5	6
4	5	5	5	5	5	5	5	5	6
4	5	5	5	5	5	5	5	5	6
4	5	5	5	5	5	5	5	5	6
4	5	5	5	5	5	5	5	5	6
16	5	5	5  	5	5	5	5	5	17
4	5	5	5	5	5	5	5	5	6
4	5	5	5	5	5	5	5	5	6
4	5	5	5	5	5	5	5	5	6

[Player]
300 2560 0 0 -0.5

[Enemies]
23
3 150 80 0 0 0.5
3 450 80 0 0 0.5
1 200 250 0 0 0.5
1 300 280 0 0 0.5
1 400 250 0 0 0.5
0 200 700 0 0 0.5
0 300 700 0 0 0.5
0 400 700 0 0 0.5
1 300 850 0 0 0.5
4 35 1000 0 0 0.5
4 575 1000 0 0 0.5
4 35 1100 0 0 0.5
4 575 1100 0 0 0.5
0 200 1250 0 0 0.5
0 300 1250 0 0 0.5
0 400 1250 0 0 0.5
4 285 1625 0 0 0.5
4 500 1625 0 0 0.5
0 300 1850 0 0 0.5
0 300 1950 0 0 0.5
0 300 2050 0 0 0.5
4 200 2050 0 0 0.5
4 400 2050 0 0 0.5

[SpecialObjects]
5
0 300 150
3 300 500
1 300 1000
3 300 1500
1 300 2400

[LastLevel] 1